{
    "blocks": [
        [0, 0, 0, 0, 0, 0, 0, 0, 1, 1],
        [0, 0, 2, 2, 2, 0, 2, 0, 0, 1],
        [0, 2, 2, 2, 2, 0, 0, 2, 2, 0],
        [0, 0, 0, 0, 0, 0, 0, 0, 0, 0],
        [1, 0, 0, 0, 0, 0, 0, 0, 0, 1],
        [1, 0, 0, 0, 1, 0, 0, 0, 0, 1],
        [1, 1, 0, 0, 0, 0, 0, 1, 1, 1],
        [1, 1, 1, 1, 1, 0, 1, 1, 1, 1],
        [1, 1, 1, 1, 1, 0, 1, 1, 1, 1]
    ],
    "finish": {
        "side": 0,
        "index": 5
    },
    "starting": [0, 1],
    "limit": 4
}