{
    "blocks": [
        [0, 0, 0, 0, 1, 0, 0, 0, 0, 0],
        [0, 0, 0, 0, 1, 0, 2, 0, 0, 0],
        [0, 0, 0, 0, 1, 0, 0, 2, 2, 0],
        [1, 1, 1, 0, 0, 0, 0, 0, 0, 0],
        [0, 0, 0, 0, 1, 0, 0, 0, 0, 0]
    ],
    "finish": {
        "side": 2,
        "index": 3
    },
    "starting": [8, 1],
    "limit": 4
}