{
    "blocks": [
        [0, 0, 0, 0, 0, 0, 0, 0, 0, 0, 0],
        [0, 0, 0, 0, 1, 1, 1, 0, 1, 1, 1],
        [0, 0, 0, 0, 0, 0, 1, 0, 0, 0, 0],
        [1, 1, 1, 0, 1, 2, 1, 0, 1, 1, 1],
        [0, 0, 0, 0, 1, 0, 0, 0, 0, 0, 0],
        [0, 0, 0, 0, 1, 2, 1, 0, 0, 0, 0],
        [0, 0, 0, 0, 0, 0, 0, 0, 0, 0, 0],
        [0, 0, 0, 0, 0, 0, 0, 0, 0, 0, 0]
    ],
    "finish": {
        "side": 1,
        "index": 4
    },
    "starting": [5, 2],
    "limit": 4,
    "next": "kirikanan"
}