{
    "blocks": [
        [0, 0, 0, 0, 0, 0, 0, 0, 0, 0, 0],
        [0, 1, 0, 1, 0, 1, 0, 1, 0, 1, 0],
        [0, 0, 0, 0, 0, 0, 0, 0, 0, 0, 0],
        [0, 1, 0, 0, 0, 0, 0, 0, 0, 1, 0],
        [0, 0, 0, 0, 0, 0, 0, 0, 0, 0, 0],
        [0, 1, 0, 0, 0, 0, 0, 0, 0, 1, 0],
        [0, 0, 0, 0, 0, 0, 0, 0, 0, 0, 0],
        [0, 1, 0, 0, 0, 0, 0, 1, 1, 2, 0],
        [0, 0, 0, 0, 0, 0, 0, 1, 0, 0, 0],
        [0, 1, 0, 1, 0, 1, 0, 2, 0, 2, 0],
        [0, 0, 0, 0, 0, 0, 0, 0, 0, 0, 0]
    ],
    "finish": {
        "side": 3,
        "index": 6
    },
    "starting": [9, 8],
    "limit": 2,
    "next": "susahbanget"
}