{
    "blocks": [
        [0, 0, 0, 0, 0, 0, 0, 0, 0],
        [0, 0, 0, 0, 0, 0, 0, 0, 0],
        [0, 1, 1, 1, 1, 1, 1, 1, 2],
        [0, 0, 0, 0, 0, 0, 0, 2, 0],
        [0, 1, 1, 1, 1, 0, 0, 0, 0],
        [0, 0, 0, 0, 0, 0, 0, 0, 0]
    ],
    "finish": {
        "side": 2,
        "index": 6
    },
    "starting": [8, 0],
    "limit": 5
}