{
    "blocks": [
        [0, 0, 0, 0, 0, 0, 0, 0, 0, 0, 0, 0 ,0],
        [0, 0, 0, 0, 1, 0, 1, 0, 0, 0, 0, 0, 0],
        [0, 1, 1, 0, 1, 0, 1, 0, 1, 1, 0, 2, 0],
        [0, 1, 1, 0, 0, 0, 0, 0, 1, 1, 0, 0, 0],
        [0, 0, 0, 0, 0, 0, 0, 0, 0, 0, 0, 2, 0],
        [1, 0, 0, 0, 0, 0, 0, 0, 0, 0, 0, 0, 0],
        [1, 0, 0, 1, 1, 1, 0, 0, 0, 0, 0, 0, 0],
        [1, 0, 0, 1, 1, 1, 0, 0, 0, 0, 0, 0, 0],
        [0, 0, 0, 1, 1, 1, 0, 0, 0, 0, 0, 0, 0],
        [1, 0, 0, 0, 0, 0, 0, 0, 0, 0, 0, 0, 1],
        [0, 1, 0, 0, 0, 0, 0, 0, 0, 0, 0, 1, 0]
    ],
    "finish": {
        "side": 0,
        "index": 7
    },
    "starting": [3, 4],
    "limit": 7,
    "next": "selektion"
}