{
    "blocks": [
        [1, 1, 1, 1, 1, 1, 1, 1, 1],
        [0, 0, 0, 0, 0, 0, 0, 1, 0],
        [2, 1, 1, 1, 1, 1, 1, 1, 0],
        [0, 0, 0, 0, 0, 0, 0, 0, 0],
        [0, 1, 1, 1, 1, 1, 1, 1, 0], 
        [0, 0, 0, 0, 0, 0, 0, 1, 0], 
        [1, 1, 1, 1, 1, 1, 1, 1, 0]
    ],
    "finish": {
        "side": 2,
        "index": 8
    },
    "starting": [0, 1],
    "limit": 4
}