{
    "blocks": [
        [0, 1, 0, 1, 0, 1, 0, 0, 0],
        [0, 0, 0, 0, 0, 1, 1, 1, 1],
        [0, 0, 0, 0, 0, 0, 0, 0, 0],
        [1, 1, 1, 0, 0, 1, 0, 0, 0],
        [0, 0, 1, 0, 0, 1, 1, 1, 0], 
        [0, 0, 0, 0, 0, 0, 0, 1, 0], 
        [1, 1, 1, 1, 0, 1, 0, 0, 0], 
        [0, 0, 0, 1, 0, 1, 0, 1, 1], 
        [0, 0, 0, 1, 0, 1, 0, 0, 0]
    ],
    "finish": {
        "side": 1,
        "index": 8
    },
    "starting": [1, 1],
    "limit": 6
}