{
    "blocks": [
        [0, 0, 0, 0, 0, 0, 0, 0, 0, 0, 0, 0, 0, 0],
        [0, 1, 0, 1, 0, 0, 2, 0, 0, 2, 0, 2, 0, 0],
        [0, 1, 0, 1, 0, 2, 0, 2, 0, 0, 2, 0, 0, 0],
        [0, 1, 1, 1, 0, 2, 2, 2, 0, 0, 2, 0, 0, 0],
        [0, 1, 0, 1, 0, 2, 0, 0, 0, 0, 2, 0, 0, 0],
        [0, 1, 0, 1, 0, 0, 2, 2, 0, 2, 0, 0, 0, 0],
        [0, 0, 0, 0, 0, 0, 0, 0, 0, 0, 0, 0, 0, 0], 
        [0, 2, 0, 1, 0, 0, 0, 0, 0, 0, 0, 1, 0, 0], 
        [1, 0, 2, 0, 0, 0, 0, 0, 0, 0, 1, 2, 1, 0], 
        [0, 0, 0, 0, 0, 0, 0, 0, 0, 0, 0, 1, 0, 0], 
        [0, 1, 1, 1, 0, 1, 1, 1, 0, 0, 0, 2, 0, 0], 
        [0, 0, 0, 0, 0, 0, 0, 0, 0, 0, 0, 2, 0, 0], 
        [0, 0, 0, 0, 0, 0, 0, 0, 0, 0, 0, 2, 0, 0]
    ],
    "finish": {
        "side": 2,
        "index": 4
    },
    "starting": [13, 3],
    "limit": 2,
    "next": "turunlah"
}